22211111111111111111111111111111111111111111111111111111222
11100000000000000000000000000000000000000000000000000000111
11100000000000000000000000000000000000000000000000000000111
11100000000000000000000000000000000000000000000000000000111
11100000000000000000000000000000000000000000000000000000111
11100000000000000000000000000000000000000000000000000000111
11100000000000000000000000000000000000000000000000000000111
11100000000000000000000000000000000000000000000000000000111
11100000000000000000000000000000000000000000000000000000111
11100000000000000000000000000000000000000000000000000000111
11100000000000000000003333333330000000000000000000000000111
11100000000000000000000000000000000000000000000000000000111
11100000000000000000000000000000000000000000000000000000111
11100000000000000000000000000000000000000000000000000000111
11100000000000000000000000000000000000000000000000000000111
11100000000000000000000000000000000000000000000000000000111
11100000000000000000000000000000000000000000000000000000111
11100000000000000000000000000000000000000000000000000000111
11100000000000000000000000000000000000000000000000000000111
22211111111111111111111111111111111111111111111111111111222